0000000000000000000000000000000000000000000000000000000000000000000000000000000000000000000<0000
000000000000000000000000000000000000000000000000000000000000000000000000000000000000000000<00000
000000000000000000000000000000000000000000000000000000000000000000000000000000000000000000<00000
000000000000000000000000000000000000000000000000000000000000000000000000000000000000000000<00000
000000000000000000000000000000000000000000000000000000000000000000000000000000000000000000<00000
000000000000000000000000000000000000000000000000000000000000000000000000000000000000000000<00000
000000000000000000000000000000000000000000000000000000000000000000000000000000000000000000000000
0000000000000000000=>?00000000000000000000000000000000000000000000=>>>?00=>>?0000000000000000000
000000000000000=>?000000000000000000000000000000000000000000=>>?0000000000000000=>?0000000000000
000000000001230000000000000000000000000000000000000000012230000000000000000000000000001300000000
122222222226662222222222222222222222222223000001222222266662222300000000012222222222226622<22223
666666666666666666666666666666666666666666222226666666666666666700000000056666666666666666<66666
000000000000000000000000000000000000000000000000000000000000000066666666600000000000000000<00000
