00000000000000000000000000000000000000000000000000000000000000000000000000000000000000000000<000
0000000000000000000000000000000000000000000000000000000000000000000000000000000000000000000<0000
0000000000000000000000000000000000000000000000000000000000000000000000000000000000000000000<0000
0000000000000000000000000000000000000000000000000000000000000000000000000000000000000000000<0000
0000000000000000000000000000000000000000000000000000000000000000000000000000000000000000000<0000
0000000000000000000000000000000000000000000000000000000000000000000000000000000000000000000<0000
0000000000000000000000000000000000000000000000000000000000000000000000000000000000000000000<0000
000000000000000000000000000000000000000000000000000000000000000000=>?00@00=>>?000000000000000000
000000000000000=>>?000000000000000000000000000000000000000000=>>?0000000000000000=>?000000000000
000000000001230000000=>230000000000000000000@000000000012230000000000000000000000000001300000000
1222222222266622222300056222222222220@0223000001222222266662222200000000000002222222226622222223
666666666666666666670005666666666666000666000006666666666666666600000000000006666666666666666666
000000000000000000066666000000000000000000000000000000000000000666666666666666666666666666666666