000000000000000000000000000000000000000000000000000000000000000000000000000000000000000000000000000000000000000000000000000000000000000000000000<0000000000
000000000000000000000000000000000000000000000000000000000000000000000000000000000000000000000000000000000000000000000000000000000000000000000000<0000000000
000000000000000000000000000000000000000000000000000000000000000000000000000000000000000000000000000000000000000000000000000000000000000000000000<0000000000
000000000000000000000000000000000000000000000000000000000000000000000000000000000000000000000000000000000000000000000000000000000000000000000000<0000000000
000000000000000000000000000000000000000000000000000000000000000000000000000000000000000000000000000000000000000000000000000000000000000000000000<0000000000
000000000000000000000000000000000000000000000000000000000000000000000000000000000000000000000000000000000000000000000000000000000000000000000000<0000000000
00000000000000000000000000000000000000000000000000000000000000000000000000000000000000000000000000000000000000000000000000000000000000000000000000000000000
000000000000000000000000000000000000000000000000000000000000000000=>?00@00=>>?00000000000000000000000000000000000000000000000000000000000000000000000000000
000000000000000=>>?000000000000000000000000000000000000000000=>>?0000000000000000=>?000000000000000000000000000000@0000000000000000000000000000000000000000
000000000001230000000=>230000000000000000000@000000000012230000000000000000000000000001300000000000000@00000000@0000000000000000000000000000000000000000000
1222222222266622222300056222222222220@0223000001222222266662222200000000000002222222226622222222222200000000@000000000@0000001222222222222222222<2222222223
666666666666666666670005666666666666000666000006666666666666666600000000000006666666666666666666666600000@0000000000000000@007666666666666666666<6666666667
00000000000000000006666600000000000000000000000000000000000000066666666666666666666666666666666600000000000000000000000000000000000000000000000000000000000